1111111111111111

1P0100000001C001
1101011101110101
1C0001E0000001C1
1111111111111111