1111111111111111
1P0000000000E0C1
1111111111111111