1111111111111111111
1P00000000000100001
1011101110111011101
1000100000000010001
1110101110111011101
1C0000000000E0000C1
1011101110111011101
1000000000000010001
1111111111111111111