111111111111111111111111111111111
1P0000000C000000000000C00000000E1
101110111011101110111011101110111
100010000000001000000000000000001
111010111011101110111011101110111
1C0000000000C000000000000000000C1
101110111011101110111011101110111
100000000000001000000000000000001
111011101110111011101110111011101
1C000C0000000C0000000000000000001
101110111011101110111011101110111
100010000000001000000000000000001
111010111011101110111011101110111
1C0000000000C000000000000000000C1
111111111111111111111111111111111